22 31 40 49 2 11 20
21 23 32 41 43 3 12
13 15 24 33 42 44 4
5 14 16 25 34 36 45
46 6 8 17 26 35 37
38 47 7 9 18 27 29
30 39 48 1 10 19 28

22 21 13 5 46 38 30 
31 23 15 14 6 47 39 
40 32 24 16 8 7 48 
49 41 33 25 17 9 1 
2 43 42 34 26 18 10 
11 3 44 36 35 27 19 
20 12 4 45 37 29 28 
