37 48 59 70 81 2 13 24 35
36 38 49 60 71 73 3 14 25
26 28 39 50 61 72 74 4 15
16 27 29 40 51 62 64 75 5
6 17 19 30 41 52 63 65 76
77 7 18 20 31 42 53 55 66
67 78 8 10 21 32 43 54 56
57 68 79 9 11 22 33 44 46
47 58 69 80 1 12 23 34 45

37 36 26 16 6 77 67 57 47 
48 38 28 27 17 7 78 68 58 
59 49 39 29 19 18 8 79 69 
70 60 50 40 30 20 10 9 80 
81 71 61 51 41 31 21 11 1 
2 73 72 62 52 42 32 22 12 
13 3 74 64 63 53 43 33 23 
24 14 4 75 65 55 54 44 34 
35 25 15 5 76 66 56 46 45
