92 67 99 74 1 51 8 58 15 40
17 42 24 49 76 26 83 33 90 65
98 73 80 55 7 57 14 64 16 41
23 48 5 30 82 32 89 39 91 66
4 54 81 56 88 63 20 70 22 47
79 29 6 31 13 38 95 45 97 72
85 60 87 62 19 69 21 71 3 28
10 35 12 37 94 44 96 46 78 53
86 61 93 68 25 75 2 52 9 34
11 36 18 43 100 50 77 27 84 59

92 17 98 23 4 79 85 10 86 11 
67 42 73 48 54 29 60 35 61 36 
99 24 80 5 81 6 87 12 93 18 
74 49 55 30 56 31 62 37 68 43 
1 76 7 82 88 13 19 94 25 100 
51 26 57 32 63 38 69 44 75 50 
8 83 14 89 20 95 21 96 2 77 
58 33 64 39 70 45 71 46 52 27 
15 90 16 91 22 97 3 78 9 84 
40 65 41 66 47 72 28 53 34 59 
