64 2 3 61 60 6 7 57
9 55 54 12 13 51 50 16
17 47 46 20 21 43 42 24
40 26 27 37 36 30 31 33
32 34 35 29 28 38 39 25
41 23 22 44 45 19 18 48
49 15 14 52 53 11 10 56
8 58 59 5 4 62 63 1

64 9 17 40 32 41 49 8 
2 55 47 26 34 23 15 58 
3 54 46 27 35 22 14 59 
61 12 20 37 29 44 52 5 
60 13 21 36 28 45 53 4 
6 51 43 30 38 19 11 62 
7 50 42 31 39 18 10 63 
57 16 24 33 25 48 56 1 
